111111
1E0001
100101
1P00C1
111111
