111111
1E0001
100101
100PC1111
111111
