111111111111111111111111111111
1E0000000000000C000C0000000001
101001010010001010010000010101
101001001010101010010000010101
1P0000000C00C000000000000000C1
111111111111111111111111111111
