111111
1E0001
100101
100P01
111111
