111111111111111111111111111111
1E0000000000000C000C0010000001
101001010010001010010010010101
111001001010101010010010010101
1P1000000C00C000000000100000C1
111111111111111111111111111111
